#,#,#,#,#,#,#,#,#,#
#,_,_,_,#,_,_,_,$,#
#,_,A,_,_,_,#,_,_,#
#,B,_,_,#,_,#,_,_,#
#,_,C,_,#,_,_,_,_,#
#,#,#,#,#,#,#,#,#,#
