#,#,#,#,#,#,#,#,#,#,#,#,#
#,C,_,_,_,#,_,#,_,_,_,D,#
#,_,_,_,_,_,_,_,_,_,_,_,#
#,_,_,_,#,_,#,_,#,_,_,_,#
#,F,#,_,_,_,$,_,_,_,#,E,#
#,_,_,_,#,_,#,_,#,_,_,_,#
#,_,_,_,_,_,_,_,_,_,_,_,#
#,B,_,_,_,#,_,#,_,_,_,A,#
#,#,#,#,#,#,#,#,#,#,#,#,#
