#,#,#,#,#,#,#,#,#,#,#,#,#,#,#,#,#,#
#,_,_,_,_,_,_,_,#,#,_,_,_,_,_,#,$,#
#,_,#,#,_,_,#,_,#,_,_,#,_,#,_,_,_,#
#,_,_,#,_,_,#,_,_,_,#,_,_,#,_,#,#,#
#,_,_,#,#,#,#,#,#,_,#,_,#,#,_,_,#,#
#,_,_,#,_,_,#,_,_,_,#,_,_,_,_,_,_,#
#,_,_,#,_,_,#,_,_,#,#,#,#,#,#,#,_,#
#,A,B,C,D,E,_,_,_,#,_,_,#,_,_,#,_,#
#,F,G,H,I,J,_,_,_,_,_,_,_,_,_,_,_,#
#,#,#,#,#,#,#,#,#,#,#,#,#,#,#,#,#,#
